%%%%%%%%%%%%%%%%%%%%%%%%%%%%%%%%%%%%%%%%%%%%%
%   %% %%     %     %   %           %%%     %
%          %     %  %%  %  %%  % %       % %%
%%  %%               %    %  %  %      %%  %%
%          %   % %%  %     %    %% %  %%    %
%%% %     %%      %    % %% % %     P% %%   %
%   %    %  %    %  %%%    %%%%%  %       % %
%%   %%             %  %       % %       % %%
%% %%% %% %      %   %  %   %%%       %    %%
%       %%     %%%  %  %    %%%  %   %      %
%        %%    %%%%   %    %% %   %   %    %%
%% %  %    %   %    %     %  %  % %       %%%
%     %  % %        %%%%   %%     % %  %% % %
%        %    %     % %      %  % %%     %  %
%          %%%%%         %      %%% % %%% %%%
%%% %%   %  % %% %  %% %    %%   %   %%%%%% %
% %     %   %% %    %       %  %%     % %   %
%%%         %  % %% %%%  %% %      %%% %% % %
%% %        %   %   %  %     %    %%%       %
%         % %% %  % %    %%% %%      %      %
%%   %% %%  %%%     %%%  % % %  %%     %%   %
%  %%%          %%         %       %   %  % %
%     % %   %    %%% %%%%     %% %% % %% % %%
%   %% %%  %   %  %%%%  %%   %     %        %
% %   %  %%%%   %%      %  %           % %% %
%   %         %   %    %             %%  %% %
%%%         %    %%  %% % %%      %  %   %% %
%       % % %   %%   %   %% %       %%  % % %
% %  %%%    %  %%%  %%  % %  %      %    %  %
%%     %    %         %%         %%     %   %
%%   % %  %% % %%     %%  %   % %  %%    %  %
%%    % %        %   %% %      %   %%    %  %
% %%  %%%     % %% %%   %      %   % %    %%%
%% % %       %  %    % %  %  %  % %   %     %
%% % % %%     %   %%        %  % %     % %% %
% %%%% %    %    %%%%   %     %    %    %  %%
%  %   %%     %%    %% %% %   %    %    %%%%%
%    % % %% %   %     %% %  % %    %     %% %
%       %      % % % %%     % %        % %% %
%% %% %  %     %%  % %    %   %%%         %%%
%      %%             % % %   %%%  %%%   %  %
% %  %  %      %    %%%%  %  % % %%%   %  % %
%     % %% %      %%              % %  %    %
%   %     % %            %   %%   %        %%
%     %     % %      %   % %  %        % %% %
%%            %%% %% %    %  %%    % %   %% %
%% %    %% %%         %%% %    %  %%     %% %
% % % %     % %  %  %%%%       %% %     %% %%
%.         %       %   %%               %  %%
%%%%%%%%%%%%%%%%%%%%%%%%%%%%%%%%%%%%%%%%%%%%%