%%%%%%%%%%%%%%%%%%%%%
%.            ...P .%
%.%%.%%.%%.%%%.%% %.%
% %% %....        %.%
%%%%%%%%%%%%%%%%%%%%%
