%%%%%%%%%%
%    % % %
%    %%% %
%  %P    %
%% %%   %%
%  %   % %
%     %  %
%        %
%%       %
%%  %  %%%
% %      %
%%%%  %  %
%       %%
%  %%%%% %
%%%   .  %
% % %%%  %
%   % %  %
%%%    %%%
%%%      %
%%%%%%%%%%
