%%%%%%%%%%%%%%%%%%%%%%%%%%%%%%%%%%%%%%%%%%%%%%%%%
%%%            %%%% %%%   %%%% %%%%            %%
%%             %%%        %%%  %%%             %%
%                                               %
%                                               %
%                          .                    %
%                                               %
%                       %%                      %
%                      %%%                      %
%                      %%%                      %
%                                               %
%                                               %
%                                               %
%                           P                   %
%                                               %
%%%            %%%%            %%%%            %%
%%%            %%%%            %%%%            %%
%%%            %%%%            %%%%            %%
%%             %%%             %%%             %%
%%                                              %
%%                                              %
%%                                              %
%%%%%%%%%%%%%%%%%%%%%%%%%%%%%%%%%%%%%%%%%%%%%%%%%
