%%%%%%%%%%%%%%%%%%%%
%           %%     %
%                  %
%  %%           %  %
%          %     % %
%           %      %
%%        %   %    %
%    %     %     % %
%  %  %            %
%        % %  %   %%
%   %              %
%                  %
%      %         % %
%            %     %
%%    %      %%    %
%                  %
%        %%        %
%                  %
%.        %     P  %
%%%%%%%%%%%%%%%%%%%%
